1 st: first
2 b: double
2b: double
2 nd: second
2p: 2-point field goals
2 pa: 2-point field goal attempts
3 b: triple
3b: triple
3 p: 3-point field goals
3p: 3-point field goals
3 par: 3-point attempt rate
3 pa: 3-point field goal attempts
3pm: 3-point field goal made
3rd: third
4th: fourth
5th: fifth
6th: sixth
7th: seventh
8th: eighth
9th: ninth
10th: tenth
#: number
$: dollar
a: attempts
ab: at bats
abbrev: abbreviation
abdnt: abandonment
abndnd: abandoned
acc: accuracy
accg: accounting
accredit: accreditation
accy: accessibility
acous: acoustics
acq: acquired
acrn: acronym
acte: acute
acust: acoustics
ad: advertisement
add: address
addict: addiction
addr: address
adr: address
addre: address
admin: administrator
advsry: advisory
aero: aerospace
afdble: affordable
affiliatn: affiliation
affirmatn: affirmation
affltd: affiliated
afrcn: african
agg: aggregate
aggr: aggregate
agri: agriculture
al: aluminum
alch: alcohol
alg: algebra
algebr: algebra
align: alignment
alloc: allocation
allotmnt: allotment
alt: altitude
amendmnt: amendment
amndd: amended
amt: amount
anal: analysis
anat: anatomy
anim: animation
anlys: analysis
ann: annual
annu: annually
anthro: anthropology
apg: assists per game
api: application programming interface
appl: application
appnc: appearance
appntmnt: appointment
appt: appointment
apr: april
apt: apartment
arab: arabic
arch: architecture
asin: amazon standard identification number
assgnd: assigned
assistv: assistive
ast: aspartate transaminase
asts: assists
athlet: athletics
atk: attack
att: attempts
attach: attachment
attndng: attending
aug: august
auth: authentication
auto: automotive
avail: available
ave: avenue
avg: average
b: ballsS
babip: batting average on balls in play
bank: banking
baro: barometer
barometrc: barometric
bb: base on balls
bch: beach
bds: beds
beg: begin
behav: behavior
biochem: biochemistry
biog: biography
biomed: biomedical
biophys: biophysics
biotech: biotechnology
biz: business
bk: bike
bld: building
blk: block
blks: blocks
bllng: billing
blr: boiler
blt: built
blvd: boulevard
bmi: body mass index
bnft: benefit
bot: botany
bp: blood pressure
bpm: beats per minute
bse: base
bsmt: basement
bst: best
busn: business
bxng: boxing
ca: number of major vessels
callr: caller
camp: camping
canc: cancer
cand: candidate
captn: caption
cardio: cardiology
carto: cartography
cat: category
categ: category
cd: code
cdt: credit
ceo: chief executive officer
cert: certification
certif: certification
cfo: chief financial officer
cgpa: cumulative grade point average
chem: chemistry
chg: change
chin: chinese
chol: cholesterol
chrgs: charges
chrtr: charter
circt: circuit
circulatn: circulation
citatn: citation
cl: chlorine
clin: clinical interpretation
clt: client
cmp: completions
cmt: complaint
cnditional: conditional
cndo: condo
cnr: corner
cnt: count
cntingency: contingency
cntr: counter
cntrast: contrast
cntrl: control
cnver: conversion
co: carbon oxide
coll: college
comm: communication
comp: companies
compl: completed
compld: complied
complnc: compliance
complt: complete
compltn: completion
composit: composition
compsci: computer science
comptr: computer
cond: condition
conf: conference
confid: confidence
confm: confirmed
conform: conformity
congressnal: congressional
consrvt: conservation
contct: contact
contrib: contributory
contry: country
coo: chief organizational officer
cook: cooking
coop: cooperation
cooperat: cooperation
corr: correspondent
corrctns: corrections
cosmet: cosmetology
countr: country
cp: chest pain
cpi: consumer price index
cpn: campaign
creativ: creativity
crs: cross
crts: courts
cs: caught stealing
csh: cash
cst: cost
cstd: custodian
ct: count
ctct: contact
cto: chief technology officer
ctrl: control
ctry: country
cty: city
curr: currency
cust: customer
cvrd: covered
cycl: cycling
d: drawn
dbt: debt
dec: decimal
declaratn: declaration
def: defending
defct: deficit
defendnt: defendant
deg: degree
deliv: delivery
deman: demand
demog: demography
dendrol: dendrology
denls: denials
dentl: dental
departmntal: departmental
depend: dependence
dept: department
dermatol: dermatology
desc: description
descr: description
descrip: description
det: detail
detectble: detectable
dev: development
devc: device
develop: development
dgt: digit
dh: datehour
diam: diameter
dif: difference
diff: difference
dig: digital
dipl: diploma
diplom: diplomacy
dir: direction
dire: directions
direct: direction
dis: disabled
dist: distance
distr: district
distribtd: distributed
dive: diving
dns: domain name system
dob: date of birth
doc: document
doced: documented
dollr: dollar
dom: dominance
downld: download
dp: dupe
dq: data quality
dr: doctor
drb: defensive rebounds
dri: dribling
drn: drone
drvng: driving
drvr: driver
ds: description
dsgn: design
dspatch: dispatch
dsposed: disposed
dspute: dispute
dst: destination
dstnc: distance
dt: date
duns: dun & bradstreet number
dur: duration
dx: diagnosis
e: errors
earnd: earned
ecg: electro cardiogram
eco: ecology
econ: economics
ed: edited
edu: education
educ: education
ees: employees
eidr: entertainment identifier registry
elec: electricity
electn: election
electve: elective
elem: elementary
eligble: eligible
empl: employee
endo: endocrinology
eng: engineering
ent: entertainment
enth: enthusiasm
ento: entomology
env: environment
envsci: environmental science
epi: epidemiology
epist: epistemology
eq: equality
equip: equipment
estblshd: established
eth: ethnology
ethnc: ethnic
ety: etymology
evn: even
exang: exercise induced angina
exhbt: exhibit
exp: experience
expec: expected
expect: expectancy
expl: explorer
expns: expenses
exst: exist
extns: extension
factrs: factors
fail: failure
fam: family
famsup: family support
faq: frequently asked questions
fatl: fatal
fbs: fasting blood sugar
fd: feed
feat: features
featr: feature
feb: february
fedu: father education
fem: female
ferm: fermentation
fg: field goals
fga: field goal attempts
fgm: field goals made
fil: file
fin: finance
financ: financing
finnc: finance
fire: fire fighting
fish: fishing
fjob: father job
fk: free kicks
fl: flag
fld: field
fll: full
flnm: filename
flr: floor
flt: flight
flu: influenza
flwr: flower
fn: fund
fndly: friendly
foc: focus
foodsci: food science
for: forestry
fp: field points
fr: fair
frcast: forecast
freq: frequency
frid: friday
frm: form
ft: free throws
fta: free throw attempts
ftbl: football
ftg: footage
ftm: field throws made
fum: fumble
func: function
fund: funded
fxd: fixed
g: games
gaa: goals against average
gal: gallery
garg: garage
gat: gate
gb: games behind
gdn: garden
gdp: gross domestic product
gen: genetics
geo: geography
geom: geometry
geron: gerontology
gl: goal
gms: games
gnd: ground
gp: games played
gpa: grade point average
gr: grade
grad: graduation
grds: grades
grns: greens
grnt: grant
grp: group
gs: games started
gtin: global trade item number
gwg: game winning goal
gym: gymnastics
h: hits
handl: handle
hardwr: hardware
hb: hemoglobin
hbp: hit by pitch
hea: health
headln: headline
herp: herpetology
hgt: height
hp: horse power
ht: height
hik: hiking
hist: history
hll: hall
hm: home
hndc: handicap
hort: horticulture
hosp: hospitalizations
househld: household
hr: heart rate
hrd: hard
hrly: hourly
hrs: hours
hs: high school
hse: house
hum: humidity
ht: height
hunt: hunting
hvy: heavy
hydro: hydrology
ibb: intentional walk
ich: ichthyology
idl: idle
ignitn: ignition
img: image
imm: immunology
imposd: imposed
imprvd: improved
inactve: inactive
inbnd: inbound
inc: income
incdns: incidents
incremnt: increment
inddes: industrial design
indep: independent
infdis: infectious diseases
infnt: infant
info: information
inspc: inspections
inspectr: inspector
instl: install
int: interception
intrel: international relations
intrm: interim
intro: introduction
intvl: interval
inv: inventory
invo: invoice
ip: internet protocol
ipv4: internet protocol
ipv6: internet protocol
iq: inteligence quotient
isic: international standard of industrial classification of all economic activities 
iso: international organization for standardization
iss: issue
jan: january
jpn: japanese
jul: july
just: justice
k: strikeout
kinem: kinematics
kines: kinesiology
knwl: knowledge
kor: korean
kph: kilometers per hour
l: losses
lab: laboratory
lang: language
lat: latitude
latin: latino
lbl: label
legislatn: legislation
len: length
lettr: letter
lexic: lexicology
lgl: legal
lib: liberty
lim: limit
limn: limnology
ling: linguistics
lit: literature
lng: longest run
loc: location
long: longitude
lowr: lower
lrg: large
lt: lot
ltr: letter
machlearn: machine learning
maj: major
malac: malacology
manag: management
marbio: marine biology
margn: margin
market cap: market capitalization
martarts: martial arts
math: mathematics
max: maximum
mdvp: medical voice parameter
meas: measurement
mech: mechanics
med school: medical school
med size: medium size
medu: mother education
mem: memory
memo: memorandum
meta: metaphysics
mfcc: mel-frequency cepstral coefficients
mfg: manufacturing
mghertz: megahertz
mjob: mother job
mgmt: management
mi: miles
mid: middle
mil: military
mins: minutes
mk: make
mle: male
mn: mean
mngr: manager
mnths: months
mnth: month
mon: month
mo: month
mobil: mobile
mod: modified
modificatn: modification
mond: monday
moto: motorcycle
mov: movie
mp: minutes played
mpg: miles per gallon
mph: miles per hour
mpn: manufacturer part number
mps: mips
mrkt: marketing
mrktng: marketing
mth: month
mtn: mountain
mtrc: metric
mus: music
mycol: mycology
myst: mystery
myth: mythology
n: number
na: sodium
naics: north american industry classification system code
nano: nanotechnology
narr: narrative
nat: nature
natsci: natural science
nbr: number
nds: needs
ndvi: normalized difference vegetation index
ndwi: normalized difference water index
nephr: nephrology
netw: networking
neurobio: neurobiology
neurol: neurology
neurosci: neuroscience
noc: national olympic committee
nov: november
nr: number
nsn: nato stock number
ntwrk: network
nul: null
num: number
numbr: number
numer: numerology
numis: numismatics
nurs: nursing
nursng: nursing
nutr: nutrition
nxt: next
objve: objective
obligtns: obligations
obp: on-base percentage
occpd: occupied
occurrnc: occurrence
oceano: oceanography
oct: october
odonto: odontography
ofc: office
oldpeak: old peak
onln: online
oper: operations
opn: open
opp: opponent
opr: operator
ops: on-base plus slugging percentage
optn: option
optom: optometry
orb: offensive rebound rate
ornith: ornithology
os: operating system
othr: other
outbnd: outbound
ovhd: overhead
ovr: overall
p: points / played
pa: plate appearances
pac: pace
pal: paleontology
parch: parents children
pars: parasitology
pas: passing
pass: passing
path: pathology
pay: payment
payrll: payroll
pchs: purchasing
pclass: passenger class
pcode: postal code
pct: percentage
pctil: percentile
pd: period
peakrpm: peak rotations per minute
pen: penalty
per: player efficiency rating
perc: percentage
perm: permanent
pers: personnel
petitn: petition
petr: petrology
pf: personal fouls
pharm: pharmacy
philanth: philanthropy
philol: philology
philos: philosophy
phn: phone
phon: phone
photochem: photochemistry
photog: photography
phys: physics
physiol: physiology
pic: photo
pim: penalty infraction minutes
pin: pitches per inning pitched
pk: penalty kicks
plan: planning
plansci: planetary science
pln: plan
pls: plus
plumb: plumbing
pm: particulate matter
pmt: payment
poet: poetry
polit: politics
politsci: political science
poly: polygon
por: portuguese
pos: position
poten: potential
povrty: poverty
pow: power
ppb: parts per billion
ppg: points per game
ppl: people
ppm: parts per million
ppnts: participants
prbatn: probation
prc: parcel
prcessed: processed
prdictor: predictor
prdominant: predominant
precipcover: precipitation cover
precipprob: precipitation probability
preciptype: precipitation type
precip: precipitation
pred: prediction
pref: preference
prep: preparation
prev: previous
prfit: profit
prid: pride
primatol: primatology
prmeter: perimeter
procrmnt: procurement
prod: product
prof: professor
prog: program
progm: programming
proj: project
prp: prop
prponent: proponent
pst: post
pstal: postal
pstatus: parent status
psted: posted
psting: posting
psych: psychology
psycholing: psycholinguistics
psychophys: psychophysics
ptg: painting
pth: path
pts: points
pty: party
pub: public
pubhealth: public health
publ: publishing
pubrel: public relations
pulm: pulmonology
pw: power
pymt: payment
qa: quality assurance
qlty: quality
qry: query
qt: quantity
qtr: quarter
qty: quantity
qual: quality
quantcomp: quantum computing
quantmech: quantum mechanics
quantphys: quantum physics
radiatn: radiation
radiol: radiology
r: rebounds
ram: random access memory
rbi: runs batted in
rcd: record
rcnt: recent
rcpts: receipts
rcrd: record
rcv: received
reb: rebounds
rec: received
recpt: receipt
recurrnc: recurrence
recy: recycling
reest: realestate
reg: region
rehab: rehabilitation
rehabilitatn: rehabilitation
relevnc: relevance
reliab: reliability
renen: renewableenergy
req: request
reqs: requirements
reqstd: requested
res: residence
restecg: resting electro cardiogram
reservatn: reservation
resmgmt: resource management
resp: responsible
resrc: resources
resrv: reserve
rev: revenue
revsn: revision
rh: relative humidity
rheo: rheology
rk: rank
rm: room
rmt: remote
rng: range
rnk: rank
robo: robotics
rpg: rebounds per game
rpm: rotations per minute
rpt: report
rqst: request
rsdncy: residency
rsdnt: resident
rsk: risk
rt: rate
ru: russian
run: running
sanit: sanitation
sat: saturday
sav: savings
sb: stolen base
sbgrp: subgroup
sbttl: subtotal
sc: succint description
sch: school
schl: school
scholrshp: scholarship
sci: science
scien: science
scrcr: scorecard
sctr: sector
sculp: sculpture
sec: section
secty: security
secy: security
selfemp: self employed
selfest: self esteem
selfimp: self improvement
semio: semiotics
sep: september
ser: series
serv: service
sgner: signer
sh:  sacrifice bunt
sht: shot
sho: shooting
sku: stock keeping unit
sib: siblings
simul: simulation
singl: single
sit: situation
siz: size
ski: skiing
sl: soil
slg: slugging percentage
snowdepth: snow depth
so2: sulphur dioxide
so 2: sulphur dioxide
socbio: sociobiology
socc: soccer
socio: sociology
softdev: software development
softeng: software engineering
sog: shots on goal
sol: solution
solr: solar
sou: sound
sp: space
spaceexp: space exploration
spch: speech
spd: speed
spec: spectroscopy
spg: steals per game
spnd: spending
spo: sport
sposci: sports science
spt: spot
sqft: square foot
sq ft: square foot
sq mt: square meters
sqm: square meters
sr: strike rate
srch: search
srt: start
ss: strength schedule
stat: status
std: standard
stddev: standard deviation
stff: staff
stl: steals
stls: steals
strt: start
stu: student
stud: student
submsn: submission
sun: sunday
supp: support
surg: surgery
surv: survey
sust: sustainability
svc: service
sym: symbolism
synbio: synthetic biology
sys: system
t: ties
taxi: taxidermy
taxo: taxonomy
tb: total bases
tchr: teacher
td: touchdown
tds: touchdowns
team: teamwork
tech: technology
tel: telecommunications
temp: temperature
templte: template
tfidf: term frequency inverse document frequency
tfl: tackle for loss
thal: thalassemia type
thea: theatre
theo: theology
ther: therapy
thermo: thermodynamics
tim: time
tit: title
tkn: taken
tkng: taking
tm: team
tmp: temporary
tms: times
topo: topology
tot: total
tov: turnovers
tour: tourism
toxic: toxicology
tp: type
tpg: turnovers per game
tr: tree
trad: tradition
train: training
tran: transaction
trans: translation
trav: travel
trb:total rebounds
trd: trade
trestbps: resting blood pressure
trm: term
trned: turned
trp: trip
tsk: task
tst: test
ttl: total
tues: tuesday
tv: television
tx: tax
txt: text
typ: type
typo: typography
typs: types
uk: unique key
uncmt: uncommitted
unemp: unemployment
unemploymnt: unemployment
uniq: unique
univ: university
upld: upload
urb: urbanism
urbplan: urban planning
uri: uniform resource identifier
usr: user
vaca: vacation
vacc: vaccine
val: value
valuatn: valuation
vat: value added tax
veh: vehicle
vel: velocity
vent: ventilator
verif: verification
ves: vessel
vetmed: veterinary medicine
vetsci: veterinary science
vfo: variable frequency oscillator
vic: victory
vict: victory
viro: virology
vis: vision
visart: visualart
vl: value
vol: volume
volc: volcano
volv: volcanology
vorp: value over replacement
vort: vortex
vs: versus
vst: visit
vstor: visitor
vtr: voter
vuln: vulnerable
vw: view
w: wins
wd: wide
wea: weather
weathr: weather
webp: webpage
wed: wednesday
weekd: weekday
wei: weight
wetlnd: wetland
wgt: weight
whip: walks and hits per inning pitched
whl: wholesale
wifi: wi-fi
winddir: wind direction
winddirection: wind direction
windgust: wind gust
windspeed: wind speed
wkfc: workforce
wnd: wind
wood: woodworking
wrd: ward
writtn: written
wrk: work
wrks: works
ws: win shares
wst: waste
wt: weight
wtch: watch
xeno: xenobiology
y: y variable
yd: yard
yds: yards
yrly: yearly
yrs: years
yth: youth
yr: year
yy: year
yyyy: year
zn: zone
